111111111111111111111111
10000000000E00P00000C011
111111111111111C11110011
111111111111111111111111