111111111111111111111111
10000000000000P000000001
1000000P000C000000000001
100000000000000000000001
111111111111111111111111