111111111
1F0CF01C1
10C0001P1
100001101
10000C101
101000101
100000101
1E00F0001
10C000001
111111111