111111111
100C001C1
10C000101
100001001
10000C001
101000001
100000101
1E00000P1
10C000001
111111111