111111111111111111111
10000010001000000P001
10000000E0100C0010011
110C00001000000100101
111111111111111111111