111111111
100000001
100000001
100000001
100000001
100000001
100000001
1E00000P1
10C000001
111111111